......***.............
..*****q**************
..*.....**..........**
..*.******.********.**
..*.*...**.*........**
..*.*.*.**.*.*********
***.*.***....*.......*
*.......*.*.*..***.***
*.*****.*.*.*.****.*.*
*.*.....*.*.*.*....*.*
*.*.***.*.*.*.*.**.*.*
*.*.**..*.*...*.**.*.*
*.*.*****.*****.**.*.*
*.*.......**....**...*
*.**********.*****...*
*..*.*.....*.*....**.*
****.*..@..*.*.**.**.*
.....*....**.*.**.**.*
.....*....*..*.*.....*
.....**.********.***.*
......*........*.*.*.*
.******.**.***.***.*.*
.*...........*..**.*.*
.*.**.*.**.**.*.**...*
.*.**.*.**....*.***.**
.*.*..*..*.****.***.*.
.*.*.***.*.*....***.*.
.*.....*...*.****...*.
.*****.*****.*....***.
.....*.......*.**.*...
..****.*******.**.*...
..*.............*.*...
..*.***********.*.*...
..*.*...*.......*.*...
..*.*.***..******.*...
..*.*...*.........*...
..*...*************...
..******..............