.*...**.**.
**..*...***
*.**...**..
*.*.*.*.***
.*.**.**.**
**..**.**.*
.***.*.*...
*..**.**.**
.*.***.***.
.*.*******.
*.***.*****